111111111111111111111111111111111111111111
1E000000000000000000000C00000C000000000001
101001010000000000100000101001000000010101
1010010010101010001001000000000000C0010101
1P0000000C00C000000000000000000000000000C1
101001010000000000100000101001000000010101
10100101000C000000100000101001000000010101
101001010000000000100000101001000000010101
111111111111111111111111111111111111111111